________________________________________________________________________________________________
|@ **      **  **      **          **  **      **  **  **      **      **  **      **          |
|  ******  **  **      ******  ******  ******  **  **  **  J   **  ******  ******  **  ********|
|      **              **  **          **  **                      **  **  **      **          |
|  **  ******  **  **  **  **  **********  **  **  **  **************  **  **  ******  ********|
|  **      **  **  **          **          **  **  **          **      **                  **  |
|  **  **  **  **********************  **  **  **  **************  ******  ********      ****  |
|  **  **  **          **      **      **      **  **  **  **      **  **  **                  |
|********  **  **********  ******  **  **************  **  **  ******      **  **  **  **  ****|
|          **  **                  **                                  **  **  **  **  **      |
|  ******  **  **  **  ******  **********  ******  ******  **  **********  **  ******  ********|
|      **          **  **          **          **      **  **                      **      **  |
¯¯¯¯¯¯¯¯¯¯¯¯¯¯¯¯¯¯¯¯¯¯¯¯¯¯¯¯¯¯¯¯¯¯¯¯¯¯¯¯¯¯¯¯¯¯¯¯¯¯¯¯¯¯¯¯¯¯¯¯¯¯¯¯¯¯¯¯¯¯¯¯¯¯¯¯¯¯¯¯¯¯¯¯¯¯¯¯¯¯¯¯¯¯¯¯
